10
#S########
#.#......#
#.....##.#
#####.##.#
#......#.#
######...#
#......###
#.######.#
#........#
########G#
